++++++++++++++++++++++++++++++++++++++++++++++++
+                                              +
+    ++++++     ++++++    +++ +++    +++++++   +
+    +          +    +    + + + +    +         +
+    +          +    +    + + + +    +         +
+    +   ++     ++++++    + + + +    ++++++    +
+    +    +     +    +    +  +  +    +         +
+    +    +     +    +    +     +    +         +
+    ++++++     +    +    +     +    +++++++   +
+                                              +
+    ++++++     +    +    +++++++    +++++++   +
+    +    +     +    +    +          +     +   +
+    +    +     +    +    +          +++++++   +
+    +    +     +    +    ++++++     ++++      +
+    +  G +     ++  ++    +          +  ++     +
+    +    +      ++++     +          +   ++    +
+    ++++++       ++      +++++++    +    ++   +
+                                              +
+                                              +
+    +++ +++ +++ +++ +++                       +
+    +   + + + + + + +    +                    +
+    +++ +   + + +++ +++                       +
+      + + + + + ++  +    +                    +
+  G +++ +++ +++ + + +++     G                 +
+                                              +
++++++++++++++++++++++++++++++++++++++++++++++++
                                                
